F 100,100,215
C 100,100,100

R 240 360

NO textures/stone.xpm

SO textures/gold_block.xpm

EA textures/bee_nest_bottom.xpm

WE textures/red_wool.xpm

S textures/mario.xpm

1111111111111111111111111
1000000000110000000000001
1011000001110000002000001
1001000000000000000000001
1001000000000000000000001
1001000000000000002000001
1001000000000000000000001
1001000000220000000000001
100100000000000000S000001
1001000000000000000000001
1000000000110000001000001
1000000000110000001000001
1000000000110000000000001
1000000000110000000000001
1000000000110000002000001
1000000000110000000000001
1111111111111111111111111