

F 255,255,0
C 0,111,111

R     640 480

NO textures/stone.xpm

SO textures/gold_block.xpm

EA textures/bee_nest_bottom.xpm

WE textures/red_wool.xpm












S textures/mario.xpm



11111111111111111111
111110000000001110001
1111200000000000000001
11100000000000020000001
110000000020000000000001
100E000000000000020000001
1111111111111111111111111
