

F 255,255,0
C 0,0,255

R     1920 1080

NO textures/stone.xpm

SO textures/gold_block.xpm

EA textures/bee_nest_bottom.xpm

WE textures/red_wool.xpm












S textures/mario.xpm

11111111111111111111
111110000000001110001
1111200000020000000011
11100000000200020000101
110000000020000000000001
100E000000020000020000001
1111111111111111111111111
