

F 255,255,0
C 0,0,255

R 30 30

NO textures/stone.xpm

SO textures/gold_block.xpm

EA textures/bee_nest_bottom.xpm

WE textures/red_wool.xpm

S textures/mario.xpm

        1111111111111111111111111
        1000000000110000000000001
        1000000000110000000000001
        1000000000110020202000001
        1000000000110000000000001
        1000000000110000000000001
        1000000000110000000000001
        1000000000110000000000001
        1000000000110000020000001
        1000000000110000000000001
        1000000000110000000000001
        100000000011000000000001
        101100000111000002000001
        1001200000000000W00000001
111111111111111111111111111111111