

F 255,255,0
C 0,0,255

R 2080 1560

NO textures/stone.xpm

SO textures/gold_block.xpm

EA textures/bee_nest_bottom.xpm

WE textures/red_wool.xpm

S textures/mario.xpm

        1111111111111111111111111
        1000000000110000000000001
        1000000000110000000000001
        1000000000110020202000001
        1000000000110000000000001
        1000000000110000000000001
        1000000000110000000000001
        1000000000110000000000001
        1000000000110000020000001
        1000000000110000000000001
        1000000000110000000000001
        100000000011000000000001
        1011000001110000002000001
        1001000000000000S00000001
111111111111111111111111111111111