F 255,255,0
C 0,0,255

R 1920 1080

NO textures/stone.xpm

SO textures/gold_block.xpm

EA textures/bee_nest_bottom.xpm

WE textures/red_wool.xpm

S textures/mario.xpm

        1111111111111111111111111
        1000000000110000000000001
        1011000001110000002000001
        1001000000000000000000001
111111111011000001110000000000001
100000000011000001110111111111111
11110111111111011100000010001
11110111111111011101010010001
11000000110101011100000010001
1000200000000W001100000010001
10000000000000001101010010001
1100000111010101111101111000111
11110111 1110101 101111010001
11111111 1111111 111111111111